XXXXXXXXXXXXXXXXXXXXXXXXX
X       OOOOOOOOO  O   pX
X X X X X X X X XOX X X X
X   O  OO   OOOOOO   O  X
X X XOX X X X X XOX X XOX
X        OOOOOOOOO  OO OX
X X XOX X X X X XOX X X X
X       O        O   OOOX
X X X XOX XOX X XOX X X X
X          OOOOO     O  X
X X X X X X XOX X X X XOX
X OOOOOOO  OO     OOOOOOX
X X X X X X X X X X X X X
X      OOOOOOOOOOOOOO   X
X X X X X X XOX X X X X X
XOOOOOOOOOOO            X
X X X X X XOXOXOX X X X X
X            OOOOOOOOOO X
X X X XOXOXOX XOX X X X X
XO    OOOOOOOOOOOOO     X
XOX X XOX XOX XOX X X X X
XO              OO      X
XOX XOX X X X XOXOXOX X X
X    OOO           OOO  X
X X X X X X X X X XOXOX X
Xq    O   OOOOOOOOOOO   X
XXXXXXXXXXXXXXXXXXXXXXXXX